NO textures/wall_1.xpm textures/wall_1.xpm textures/wall_1.xpm
SO textures/wall_2.xpm
WE textures/wall_3.xpm
EA textures/wall_4.xpm   textures/wall_2.xpm textures/wall_1.xpm
NO textures/wall_2.xpm
F 118,124,135     
C 99,99,99

11111111111111111111
10000000000000000001
10121000001010010001
10200111101000010001
10100000101110010001
10101100100000010001
10100110111111110001
10110100100000000001
10000100100000000001
10110110100000100001
10010010100111100001
10001110100000000001
1010100010000000N001
10100011100000000001
11111111111111111111