NO textures/wall_1.xpm textures/wall_1.xpm textures/wall_1.xpm
SO textures/wall_2.xpm
WE textures/wall_3.xpm
EA textures/wall_4.xpm   textures/wall_2.xpm textures/wall_1.xpm
NO textures/wall_2.xpm
F 118,124,135     
C 99,99,99

        1111111111111111111111111
        1002000000110000000000001
        1011000001110000000000001
        1001000000200N00000000001
111111111011000001110000000000001
100000000011000001112111111111111
11112111111111211100000010001
11110111111111011101010010001
11000000110101011100000020001
10000000000000001100000010001
10000000000000001101010010001
11000001110101011111011110001                    11111
11110111 1110101 101111010001                    10001
11111111 1111111 111111111111                    11111