NO textures/wall_1.xpm
SO textures/wall_2.xpm
WE textures/wall_3.xpm
EA textures/wall_4.xpm

F 76,76,76
C 99,99,99

1 1 1 1 1 1 1 1 1 1 1 1 1 1 1 1 1 1 1 1
1 0 0 0 0 0 0 0 0 0 0 0 0 0 0 0 0 0 0 1
1 0 1 2 1 0 0 0 0 0 1 0 1 0 0 1 0 0 0 1
1 0 2 0 0 1 1 1 1 0 1 0 0 0 0 1 0 0 0 1
1 0 1 0 0 0 0 0 1 0 1 1 1 0 0 1 0 0 0 1
1 0 1 0 1 1 0 0 1 0 0 0 0 0 0 1 0 0 0 1
1 0 1 0 0 1 1 0 1 1 1 1 1 1 1 1 0 0 0 1
1 0 1 1 0 1 0 0 1 0 0 0 0 0 0 0 0 0 0 1
1 0 0 0 0 1 0 0 1 0 0 0 0 0 0 0 0 0 0 1
1 0 1 1 0 1 1 0 1 0 0 0 0 0 1 0 0 0 0 1
1 0 0 1 0 0 1 0 1 0 0 1 1 1 1 0 0 0 0 1
1 0 0 0 1 1 1 0 1 0 0 0 0 0 0 0 0 0 0 1
1 0 1 0 1 0 0 0 1 0 0 0 0 0 0 0 N 0 0 1
1 0 1 0 0 0 1 1 1 0 0 0 0 0 0 0 0 0 0 1
1 1 1 1 1 1 1 1 1 1 1 1 1 1 1 1 1 1 1 1